000000000000000000000000000000000000
000000000000000000000000000000000000
000000000000000000000000000000000000
000000011110000000000000011110000000
000100000010000000000000010000000000
000100000010000000000000010000001000
000100000010000000000000010000001000
000100000000000000000000000000001000
000100000000000000000000000000001000
000100000000000000000000000000001000
000100000000000000000000000000001000
000100000000000000000000000000001000
000100000000000000000000000000001000
000100000010000000000000010000001000
000100000010000000000000010000001000
000100000010000000000000010000001000
000000011110000000000000011110000000
000000000000000000000000000000000000
000000000000000000000000000000000000
000000000000000000000000000000000000